Formato:
	Palabra = 1. (Tipo) Definicion. Ejemplo: x. 2. (Tipo) Definicion. Ejemplo:.
Ahuevao = (Adj.) Huevón, lento, imbécil.
Ahuevasón = (Sust.) Tontería, idiotez.
Atorrancia = 1. (Sust.) Vagancia, pereza. 2. (Sust.) Frase o acción que no tiene sentido.
Ayala = (Interjec.) Manera de expresar sorpresa o enojo. También se pronuncia "áshala". Comúnmente dicho con otras palabras. Ejemplo: "Áyala peste", "áyala maquina", "ayala vida".
Bérraco = 1. (Sust.) Persona hábil. 2. (Adj.) Furioso; difícil.
Berrinche = (Sust.) Armar un escándalo o necedad. Ejemplo:  Ese niño tiene un berrinche. 2. (Sust.) Olor fuerte a orine. Ejemplo:  Este baño huele a berrinche.
Birria = (Sust.) Juego muy repetitivo sin espíritu de competencia o finalidad alguna, comúnmente usado para los videojuegos, fútbol o baloncesto.
Biencuidao = (Sust.) Individuo que se gana la vida cuidando autos y consiguiendo estacionamientos en lugares como centros comerciales, discotecas, cines, almacenes.
Bate = (Sust.) Algo ficticio, asombroso o espectacular, una exageración. Ejemplo: ¡Qué bate!
Botar = (Sust.) Decir una atorrancia. Ejemplo: ¡Vaya, Pepito la botó!
Bote = (Sust.) Pedido para dar un aventón a algún lugar. Ejempo: Ey, un bote pue'.
Brujo = (Adj.) Barato, de poca calidad.
Buco = (Adv.) Mucho. Ejemplo: Hay buco de comer.
Bueno = (Adj.) Que está muy bonita y/o tiene buen fisico. Ejemplo:  Mami 'tas buena.
Burundanga = (Sust.) Alimento de poco valor nutritivo como caramelos, chocolates, chicles, etc.
Bochinche = (Sust.) Chisme.
Camarón = (Sust.) Actividad extracurricular que permite a un individuo ganar dinero extra. Su origen se remonta a los tiempos en que los gringos le decían a los locales "Come around..." (pásate por aquí). Ejemplo:  Voy a hacer un camarón.
Chombo = (Sust.) Persona de raza negra.
Chantin = (Sust.) Casa, hogar.
Chilin = 1. (Adj.) Tranquilo. 2. (Verb.) Parkear cool. Ejemplo: "Estaba parkeando chillin en la chantin."
Chichí = 1. (Sust.) Forma cariñosa de decir bebé. 2. (Sust.) Forma cariñosa de decirle a la novia o al novio.
Chenchen = (Sust.) Dinero.
Chicha = (Sust.) Refresco o bebida fermentada.
Chinguear = (Verb.) Apostar.
Chiva = (Sust.) Transporte colectivo de capacidad media.
Chiwi = (Sust.) Una merienda que viene del inglés "cheese whiz".
Cholo = (Sust.) En zonas del interior, se usa para referirse a un amigo. En zonas urbanas, se usa para referirse a personas del interior.
Chotear = (Verb.) Dícese de un saludo amistoso que puede o no ir asociado a golpearse las palmas de las manos efusivamente en señal de celebración o aprobación. En las regiones del interior del país la connotación puede también estar ligada a embromar (vacilar) a otro, mediante un chiste o una broma.
Cool = (Adj.) Bien, bueno.
Cuara = (Sust.) 25 centavos. Viene del inglés "quarter".
Conflei = (Sust.) Hojuelas de maíz. Cualquiera clase de cereal.
Chuleta = (Interjec.) Exclamación de sorpresa o admiración.
Chupar = (Verb.) Ingerir bebidas alcohólicas.
Chuzo = Ver "Chuleta".
Coscorrón = 1. (Sust.) (normalmente "cocorrón") Insecto redondo y cafe. 2. (Sust.) Golpe dado con los nudillos.
Chequear = (Verb.) Revisar
Queloquee = (Expresión) Sinónimo de ¿Qué hay de nuevo?. Pronunciado "que lo que é" o "queloqué".
Culantro = 1. (Sust.) Una bella dama. Proveniente del Segmento Doble Vida del programa televisivo Parecen Noticias. 2. (Sust.) Planta que se utiliza para sazonar sopas y otros alimentos.
Culei = (Sust.) Bebida Instantánea Kool-Aid.
Compa = (Sust.) Frase cariñosa refiriéndose a un campesino, a un compadre o buen amigo.
Dain = (Sust.) 10 centavos. Viene del inglés "dime".
Datien = (Sust.) Tienda (sílabas "tien-" y "-da" puestas al revés lo cual es común en Panamá y se llama un traspalante).
DiabloRojo = (Sust.) Autobús generalmente pintado de varios colores procedente de las escuelas estadounidenses que comúnmente se les llama borradores por el efecto que produce durante una colision.
Fren = (Sust.) Amigo. Viene del inglés "friend".
Focop = (Adj.) Feo, en mal estado. Viene del inglés "fucked up". 
Fulo = (Adj.) Rubio/a.
Fundillo = (Sust.) Trasero.
Gallo = 1. (Adj.) Barato, de poca calidad. 2. (Sust.) Persona sin gracia.
Garnatón = (Sust.) Bofetón. También se usa "garnatada". Garnatada normalmente se pronuncia "garnatá".
Grajo = (Sust.) Sudor de las áxilas sumamente apestoso.
Guacho =1. (Sust.) Sopa espesa que lleva ñame, yuca, culantro, arroz, verduras y alguna carne, que puede ser res, rabito de puerco o chicharrón. El guacho se sirve tradicionalmente en una "totuma", plato que se fabrica partiendo a la mitad unos frutos redondos y duros que crecen en el monte. 2. (Sust.) La combinacion de varias cosas.
Guachiman = (Sust.) Celador nocturno (anglicismo, derivado de "watchman").
Guaro = (Sust.) Alcohol, bebiba alcohólica, licor.
Guial = (Sust.) Chica/mujer. Viene del inglés "girl".
Huevear = (Verb.) Perder el tiempo de la peor forma. Ejemplo: ¡Pónte a trabajá y deja de 'ta hueveando!
Joder = (Verb.) Sinónimo vulgar de bromear, molestar, irritar. Ejemplo: "¡No jodas!"
JuegaVivo = (Adj.) Oportunista, con astucia, generalmente sin moral.
Laope = (Sust.) Pelao, muchacho (sílabas "pe-" y "-lao" puestas al revés lo cual es común en Panamá y se llama un traspalante).
Levante = (Sust.) Alguien con el/la cual hay química.
Liquipeiper = (Sust.) Palabra usada para los correctores líquidos. Viene del inglés liquid paper.
Limpio = (Adj.) Sin dinero.
Lleca = (Sust.) Calle (sílabas "ca-" y "-lle" puestas al revés lo cual es común en Panamá y se llama un traspalante).
Loco = (Sust.) Es como se llaman a los amigos de cariño. Muy común entre oriundos de Panamá.
Machoemonte = (Sust.) Tipo mas fuerte que Rambo.
Man = (Sust.) Literalmente se traduce "hombre", pero se usa para referirse a cualquier persona, incluso mujeres (la man). También se usa de muletilla. Ejemplo: Pero es que, man, no quiero ir.
Manzanillo = (Sust.) Persona sin personalidad, influenciable con facilidad.
Mafá = 1. (Sust.) Abrebocas de harina (fritura) en forma de trenza. 2. (Sust.) Dícese de un enredo, asunto complicado. 3 (Sust.) Personas abrazadas de forma muy afectiva. Ejemplo: Esos dos andan como mafá.
Maleante = (Sust.) Delincuente o persona que quiere ser como los delincuentes.
MeValeVerga = (Expresión vulgar) Situación que no genera ninguna clase de reacción ni de interés en la persona. También se dice, "Me vale un pepino", "me vale un comino."
Meña = (Sust.) Jóvenes de la calle de mal hablar y vestir. Denota las últimas 4 letras de la nacionalidad Panameña. 
Mili = (Adv.) Descuidado, de apuro. Viene del inglés melee. Ejemplo: Esto fue hecho de a mili.
Nevera = 1. (Sust.) Refrigeradora. 2. (Sust.) Autobús con aire acondicionado como los que van a diferentes provincias porque normalmente van a temperaturas muy frías. 3. (Sust.) Mujer cuadrada.
NoFitin = (Expresión) No me pidan, no voy a brindar.
NoMeParece = (Expresión) Frase popularmente utilizada para demostrar descontento por algo.
Ñecks = (Sust.) Versión decente de "mierda". Ejemplo:  Te wa (voy a) sacá la ñecks!!!
Ofi = (Interj.) Entendido, OK (acortación de 'oficial', utilizado para aprobar o recibir aprobación).
Ombe = (Interj.) Geez, Dios mío.
Paciero = (Sust.) Amigo, generalmente con quien se comparte parrandas.
Parquear = 1. (Verb.) Salir con alguien a pasar el rato. Ejemplo: Voy a parquear con mis amigos. 2. (Verb.) Poner a alguien en su sitio. Ejemplo: Quiso insultarme y lo parqueé. 
Parkin = (Sust.) Fiesta o reunión entre amigos.
Patatús = (Sust.) Desmayo, ataque cardíaco.
Patacón = (Sust.) Popular acompañamiento de comida, el cual consiste en rodajas de plátano aplastadas y luego fritas.
Palante = (Adv.) Reducción derivada de "para adelante".
Pay = (Sust.) Chica/mujer hermosa. Viene del inglés pie que es dulce.
Perro = (Sust.) Despectivo utilizado como sinónimo de mujeriego.
Peso = (Sust.) Moneda de 50 centavos, viene del periodo de la separación de Panama de Colombia donde equivalía el peso colombiano a 50 centavos de dólar; usado comúnmente en las peleas de gallos para cuantificar las apuestas.
Picando = (Adv.) Algo que está de moda. Su uso se debe al famoso baile del "pique", en Panamá. Ejemplo: Ese nuevo baile está picando.
Piedrero = (Sust.) Persona drogadicta que ha llegado a la indigencia por ser drogadicto.
Pilar = (Verb.) Estudiar con afón. Palabra relacionada: "pilón(a)" es alguien muy estudiso o sabelotodo.
PrakaPraka = (Adj.) Derivación de Rakataca.
Priti = (Adj.) Sinónimo de cool. Viene del inglés "pretty".
Salado = (Adj.) Persona que tiene mala suerte. Normalmente se dice "sala'o (a)". Ejemplo: Mario, tú, estás salado en la lotería.
Sarao = (Sust.) Fiesta o baile organizada generalmente por el segundo ciclo de secundaria. Típicamente se realiza en horas de la tarde, en el gimnasio de la escuela. Dícese de cualquier fiesta en que el objetivo principal es bailar.
Plena = (Sust.) Usado para referirse a canciones/ritmos de reggae panameño pero también usada para otros géneros cuando la cancion es buena.
Pinta = (Sust.) Cerveza. También se dice "fría".
Ponchera = (Sust.) Desorden, algarabía.
Sólido = (Adj.) Excelente. También "chévere".
Rakataca = (Sust.) Hombe o mujer sin clase. Derivado del sonido de las metralletas al disparar "rakatakatakatakataka" popularizado durante una canción del grupo Jam & Suppose en 1992: "Camión lleno de gun".
Rilax = (Adj.) Relajado. Viene del inglés "relax". Sinónimo de "chillin".
Rispect = (Sust.) Usado coloquialmente como saludo de alta estima. Viene del inglés "respect". Ejemplo: "Te mando un rispect".
Grubear = (Verb.) Estar con una persona por un tiempo o por una noche para pasarla bien y para nada serio o formal.
Rantan = (Adv.) Mucho.
Real = (Sust.) Moneda de 5 centésimos de balboa.
TáBien = (viene de: está bien; se le da significado según la dicción, pronunciación y el tono de la voz usada por la persona) Algo sorprendente; falso; exagerado; emocionante; todos los significados anteriores a la vez.
Tarrantan = (Adv.) Más que rantan. Muchísimo.
Tatai = (Interj.) Bye, hasta luego, nos vemos.
Tinaco = (Sust.) Cualquier cesto de basura. Su nombre proviene de "Tin & Co.", compañía que se encargaba de la recolección de la basura en Ciudad de Panamá y Colón en tiempos de la construcción del Canal de Panamá y durante mucho tiempo en Panamá que en los cestos de la basura decía el nombre de la compañía.
Chifear = (Verb.) No invitar/ignorar a alguna persona.
QueXopa = (Expresión) Derivado de ¿qué pasó? (sílabas "pa-" y "-so" puestas al revés lo cual es común en Panamá y se llama un traspalante)
Quemado = (Adj.) Persona a la cual su novio/novia esposo/esposa lo ha traicionado con otra/o.
ValeCebo = (Expresión) Dícese de una situación injusta o estúpida.
Violinista = (Sust.) Persona que acompaña a una pareja pero no debe estar presente pues la pareja quiere pasar tiempo a solas.
Vaina = (Sust.) Utilizado como comodín en conversaciones, usado por cosa (también usado en otros países con el mismo significado).
Yeyé = (Sust.) Persona adinerada que presume de su condición, comúnmente usa anglicismos en su habla.
