Berrinche = Armar un escándalo o necedad [Ejemplo:  Ese niño tiene un berrinche]. Olor fuerte a orine [Ejemplo:  Este baño huele a berrinche].
Birria = Juego muy repetitivo sin espiritu de competencia o finalidad alguna, comunmente usado para los videojuegos, futbol o baloncesto.
Biencuidao = Individuo que se gana la vida cuidando autos y consiguiendo estacionamientos en lugares como centros comerciales, discotecas, cines, almacenes.
Bate = Usado como descripción de algo ficticio, asombroso o espectacular, exageración. Ejemplo: ¡Qué bate!
Bote = Pedir que te lleven o te den un aventon a algun lugar (Hey un bote pue').
Brujo = barato, de poca calidad.
Buco = mucho (galicismo; derivado de beaucoup).
Bueno = que esta muy bonita o bonita y tiene buen fisico, [Ejemplo:  Mami 'tas wena]; también "pay" (como en "es un pay").
Burundanga = alimento de poco valor nutritivo. Ejemplo: caramelos, chocolates, chicles, etc...
Bochinche = chisme.
Camarón = actividad extracurricular que permite a un individuo ganar dinero extra. Su origen se remonta a los tiempos en que los gringos le decían a los locales "Come around..." (pásate por aquí).[Ejemplo:  Voy a hacer un camarón]
Chombo = persona de raza negra.
Chantin = casa, hogar.
Chilin = del ingles Chilling estar tranquilo; "parkear cool"; Ejemplo: "estaba parkeando chillin en la chantin".
Chichí = Forma cariñosa de decir Bebe; Forma cariñosa de deicirle a novia o novio
Chenchen = Dinero
Chicha = Refresco o bebida fermentada. (Esta palabra, recogida por la RAE y de etimología panameña es usada en Centroamérica, Chile y Perú, con ciertas variaciones)
Chinguear = apostar
Chiva = Transporte colectivo de capacidad media
Chiwi = (orignario de la palabra chesse wiz) Una merienda.
Cholo = En zonas del interior haciendo referencia a amigo, en la ciudad hace referencia a personas del interior.
Chotear = Dícese de un saludo amistoso que puede o no ir asociado a golpearse las palmas de las manos efusivamente en señal de celebración o aprobación. En las regiones del interior del país la connotación puede también estar ligada a embromar (vacilar) a otro, mediante un chiste o una broma.
Cool = (se pronuncia cul) Bien, bueno
Cuara = (originario de la palabra quarter) = 25 centavos
Conflei = hojuelas de maíz ( todos los cereales son conflei)
Chuleta = Exclamacion de sorpresa o admiracion
Chupar = Ingerir bebidas alcoholicas
Chuzo = Ver "Chuleta"
Coscorrón = (normalmente "cocorrón") insecto redondo y cafe, golpe dado con los nudillos (vease cocho)
Chequear = revisar
Queloquee = (pronunciado "que lo que é" o "queloqué") que hay de nuevo
Culantro = Una bella dama. Proveniente del Segmento Doble Vida del programa televisivo Parecen Noticias. Tambien es una un planta que se utiliza para sazonar la sopa y otros alimentos.
Culei = Bebida Instantánea Kool-Aid.
Chota = minivan de la policía. También utilizada para referirse a joder.
Compa = frase cariñosa refiriendose a un campesino o a un compadre... buen amigo.
Dain = (de "dime" en inglés) 10 centavos
Datien = traspalante de tienda
DiabloRojo = Autobus generalmente pintado de varios colores procedente de las escuelas estadounidenses que comúnmente se les llama borradores por el efecto que produce durante una colision.
Fren = (del inglés "friend") 
Focóp = /focót (del inglés "fucked up") Feo, en mal estado
Fulo = Rubio/a.
Fundillo = especificamente el orificio anal.
Gallo = Barato, de poca calidad; persona sin gracia.
Garnatón = Bofetón. Tambien se usa "garnatada". Garnatada normalmente se dice "garnatá".
Grajo = sudor de las exilas sumamente apestoso
Guacho = es una sopa espesa que lleva ñame, yuca, culantro, arroz, verduras y alguna carne, que puede ser res, rabito de puerco o chicharrón. El guacho se sirve tradicionalmente en una "totuma", plato que se fabrica partiendo a la mitad unos frutos redondos y duros que crecen en el monte. Tambien siginfica la combinacion de varias cosas.
Guachiman = celador nocturno (anglicismo, derivado de "watchman").
Guaro = Alcohol; bebiba alcohólica; licor.
Guial = (de "girl" en inglés) Chica/mujer
Huevear = Perder el tiempo de la peor forma. [Ejemplo:  Pónte a trabajá y deja de 'ta webiando!!!]
Joder = Bromear, molestar, irritar. Ejemplo: "No jodas!"
JuegaVivo = con astucia, generalmente sin moral, oportunista.
Laopé = traspalante de pelao (muchacho)
Levante = Novio/a, quiénes se gustan y tienen química entre ellos.
Liquipeiper = (del ingles liquid paper) Palabra usada para los correctores liquidos.
Limpio = Sin dinero.
Lleca = traspalante derivado de Calle
Loco = Es como se llaman los amigos de cariño. Muy comun entre oriundos de Panamá.
Machoemonte = Tipo mas tof que Rambo
Man = Literalmente se traduce "hombre", pero se usa para referirse a cualquier persona, incluso mujeres (la man). También se usa de muletilla. (ej. Pero es que, man, no quiero ir)
Manzanillo = sin personalidad, influenciable con facilidad, también se dice así a los vividores.
Mafá = abrebocas de harina (fritura) en forma de trenza; dícese de un enredo, asunto complicado, o personas abrazadas de forma muy afectiva ("como mafá").
Maleante = Delincuente o persona que quiere ser como los delincuentes.
MeValeVerga = (vulgar) Situación que no genera ninguna clase de reacción ni de interés en la persona. También se dice, "Me vale un pepino", "me vale un comino."
Meña = jóvenes de la calle de mal hablar y vestir. Denota las últimas 4 letras de la nacionalidad Panameña. También traspalante del tubérculo ñame)
Mili = (del inglés "melee") Descuidado, de apuro
Nevera = refrigeradora; autobús con aire acondicionado (dícese de los trans-provinciales [Ejemplo: Panamá-David] porque normalmente van a temperaturas muy frías); mujer cuadrada.
NoFitin = No me pidan, no voy a brindar
NoMeParece = Frase popularmente utilizada para demostrar descontento por algo.
Ñecks = Versión decente de "mierda". [Ejemplo:  Te wa (voy a) sacá la ñecks!!!]
Ofi = entendido, OK (acortación de 'oficial', utilizado para aprobar o recibir aprobación).
Ombe = geez.
Paciero = Amigo, generalmente amigos con quienes se comparte parrandas.
Parquear = Salir con alguien a pasar el rato: "parquear con mis amigos"; poner a alguien en su sitio "Quiso insultarme y lo parqueé". Normalmente la gente dice "parquiar".
Parkin = Fiesta o reunión entre amigos.
Patatús = Desmayo, ataque cardíaco
Patacón = Popular acompañamiento de comida, el cual consiste en rodajas de plátano aplastadas y luego fritas.
Palante = reducción derivada de para adelante
Pay = (originario de la palabra pie que significa dulce) Chica/mujer hermosa
Perro = Despectivo utilizado como sinónimo de mujeriego; usado como insulto.
Peso = Moneda de 50 centavos, viene del periodo de la separación de Panama de Colombia donde equivalía el peso colombiano a 50 centavos de dólar; usado comúnmente en las peleas de gallos para cuantificar las apuestas.
Picando = algo que está de moda.(Su uso se debe al famoso baile del "pique", en Panamá.)
Piedrero = persona drogadicta que ha llegado a la indigencia por ser drogadicto.
Pilar = estudiar con afón; "pilón(a)" es alguien muy estudiso o sabelotodo.
PrakaPraka = Derivacion de Rakataca.
Priti = del inglés "pretty" (bonito), sinónimo de cool.
Salado = (normalmente se dice "sala'o (a)") Persona que tiene mala suerte. Ejemplo:  Mario tu estás salado en la lotería.
Sarao = Fiesta o baile organizada generalmente por el segundo ciclo de secundaria. Típicamente se realiza en horas de la tarde, en el gimnasio de la escuela. Dícese de cualquier fiesta en que el objetivo principal es bailar.
Plena = Usado para canciones/ritmos de reggae pero también usada para otros géneros cuando la cancion es buena.
Pinta = cerveza. También se dice "fría".
Ponchera = Desorden, algarabía.
Sólido = Significa excelente. También "chévere".
Rakataca = hombe o mujer sin clase, comunmente utiliza mayormente la jerga panameña autoctona. Derivado del sonido de las metralletas al disparar "rakatakatakatakataka" popularizado durante una canción del grupo Jam & Suppose en 1992: "Camión lleno de gun".
Rilax = (del inglés "relax") Relajado. También se dice "chillin" (del inglés, "chilling".)
Rispect = Del inglés "respect"; usado coloquialmente como saludo de alta estima, Ejemplo: "te mando un rispect".
Grubear = Estar con una persona por un tiempo o por una noche para pasarla bien y para nada serio o formal.
Rantan = Mucho.
Real = Moneda de 5 centésimos de balboa.
TáBien = (viene de: está bien; se le da significado según la dicción, pronunciación y el tono de la voz usada por la persona) Algo sorprendente; falso; exagerado; emocionante; todos los significados anteriores a la vez.
Tarrantan = Más que rantan. Muchísimo.
Tatai = Bye, hasta luego, nos vemos.
Tinaco = Cualquier cesto de basura. Su nombre proviene de "Tin & Co.", compañía que se encargaba de la recolección de la basura en Ciudad de Panamá y Colón en tiempos de la construcción del Canal de Panamá y durante mucho tiempo en Panamá que en los cestos de la basura decía el nombre de la compañía. Tinaco
Chifear = No invitar/ignorar a alguna persona.
QuéXopá = traspalante, derivado de ¿qué paso?
Quemado = Persona a la cual su novio/novia esposo/esposa lo ha traicionado con otra/o.
ValeCebo = Dícese de una situación injusta o estúpida.
Violinista= Persona que acopaña a una pareja pero no debe estar presente pues la pareja quiere arropar. (veáse "arropar").
Vaina = Utilizado como comodín en conversaciones, usado por cosa (también usado en otros países con el mismo significado).
Yeyé = Persona adinerada que presume de su condición, comúnmente usa anglicismos en su habla.